ASS1	GGCTCACACCTGTAATCCCAGCACTTTGGGAGGCCAAGACCAGTGGATCACCTGAAGTCAGGAGTTCAAGACCAGCCTGCCCAACATGGTGAAACCCTGTCTCTACTAAAAATACAAAAATGTTAGCTGGGCGTGGTGTCAGGCACCTGTAATCCCAGCTACTCGGGAGGCTGAGGCAGGAGAATCACTTGATCCTGGGA
B2M	TTTAAAGTCCAAGAAGTATCTACTTAAAGTGGCCCTCAGCTCTTAAGCCATTCCTGGGGTCTTCTCCTTCAGCTTCACCCATTGGAAGGACATGCTTAGAAGACTGTGAGGAAACCCCATAAAGCAAGGAGGGTTAAACTGGGTTTTAAATTCAGTGGGTAAGTGAAGGCAAGTACCTCATCTCTCCAAGCAAGACCTGC
CAMK2A	GTCAGTTAAATATAATTGTTTTTGCCTGGGTCTACTGACAGACAGGTTTACATTGTCTCTATTACTTTTTTTTTTTTTTTTTTTTTTTTTTTTAATTTGTTTTTTGTTTTTGAGCTGGAGTTTTGCTCTCATTGCCCAGGCTGGAGTGCAGTGGTGAGATCTCAGCTCACCACAACTTCCGTCTCCCAGGTTCAAGTGAT
CAMK2B	GTCTATTTCTGGGATCTCTGTTCTATTTCATTAATCTATGTGTCTGCTCCTCTACCAATACCACACTGTCTTTATTACCGTCGCTATATGGTAAGCCCTGACATCATGAATTTTCTTCTTTTTCATACGTTTTGGCTATTCTAGTGTCTTTCCCTTTCCATATAAATTTTAAAATAAGCTTGTCTATGTCTACAAAAAAA
CAMK2D	AATTGCACGAATAAATGGGTTATTTATTTGCAGGCTATGGAAAGGCACATTATTTAGTCTCCTTTTGTACTTGATAATAGGATTTTAGGATGACACTCTTAATACTGTTAAACTTTTTTTTTTTTTTGAGACGGAGTCTTACTCTGTTGCCCAGGCTGGAGTGCAGTGGTGCGATCTTGGCTCACTGCAAACTCTGCCTC
CAMK2G	CCAGATCTTCAAAAGAAGTCAGAGATAAGGATTTTGGGGGGAGGCAGGTGAAACCTCCAGTTCATTAAAGGTTAGCAACTAATTTTTAAAAATTGTAAACTTAGGGCAGGAGAAAATAGAATGCTTAATGGTCAGATTCATCACAAAAGGCACCAATAAACTCTAGGCAAGATCTTCCAAAATTAAGAAAGTACTGAATT
CCL1	ATACAAAAAATTAGCTGGTGTGGTGGCGTGTGCCTGTAGTCCTAGCTACTTGGGAGGCAGAGGCAGGAGAATTGCTTGAGCCCGGGAGGTGCAGTGAGCCAAGATCGCGCCACTGCACTCCAGCCGGGATGACAGAGCAAGACTCCATCTCAAAAAAAAAAAAAAAGATAAACACTCAAGGGAACGGATACCCCAAATAC
CCL11	TGAGGCAGGAGGATTGCTTGAGCCTAGGAGTTTGAGGTTACAGTGAGCTGATCACGCCACTGCACTCCAGCCTGGGTGACAGAGTGAGACCCATCTCAAAAAAAAAAAAACAAAAAAAAAAAAAAAAGAAGAAGAAGAAATTAGAAGAGAAAAACTTTTGTAATTGTAATTTCATATTAATGAAATGCATATTTTTTTTT
CCL13	CTTTGTGGTTTTATCTACTTTTGGTCTCTGATGATGGTGATGTACAGATGGGTTTTCGGTGTGGATGTCCTTTCTGTTTGTTAAGTTTTCCTTCTAACAGACAGGACCCTCAGCTGCAGGTCTGTTGGAATACCCTGCCGTGTGAGGTGTCAGTGTGCCCCTGCTGGGGGGTGCCTCCCAGTTAGGCTGCTCGGGGGTCA
CCL14	AGTGAGGTGTCTAGAAACCTCAGAGACTCTCCAGTGCACTGGTCTTTTCAGACCTGCCTCCTGGAATATCCAGATGCCTGGGGCAATTATTAATAATGCAGAAGAGATGCCTTAACCTACACCAAAATACAGAGTCAGAATCTTCAGAGATGAAACCCCGAATTCTCTATTTCTGAAGTGGTCTAGGTGACCAGGTAATT
CCL16	TATCCCTAACCTCAGGATTTCCTCTCACAAGAGGGAACTTACACTCTTACACAAAAGCATCTGGGACTGTCCCTGCCAATTGCCTCATATAACACTGATACAGAGTCAAGTTTTCTTTATAAATTGAGTTTATATAAATCCCCAGTCCACATGCATGGCAAGTGTCACACAAAAATAAACTCAGAAAATTTTCATTCTCC
CCL17	TTGGCAGAAGGGGGCTATATAGTTCTATGTAATTTTATTATATGTGTAGATTTGTGTAACCACCACGACATTCAGAACACAGAATTGTTCTATCACCACAGGAACCCTCATACTACCCCTTTATAGCTCCACCAACCCTTTCCTCCCACTTCTAACCTCTGGCAAACTCTGATCTCCACCGCCACAATTTTGTTATTTCG
CCL18	AGAACTCAGCATGCTTAACATGCCAGCCTTCTGTATCAACTAAAATTGGATTCAGCTGCACAAAGAAACCCAAAACAATCCTAGCTTAAGCATGAGAGGAGTTTTTAATCTCTCAGATAAAAGTCCACAGGCCTGAGGTCCAGGCTGGTTCTGCAAAGTTGTTAAGGACCAGGCTCCTTCTAGCAGCTTCTCTCTGCCCC
CCL19	GGGGCAACAGGGGAATCACAGAATGGGACATGAAGGGGAATTTCAGGCAGAGAAAGTGAAGCTCTGGCCATAAATAGGAGTCAGCTGCAGGGCTCACATTCCCAGCCTCACATCACTCACACCTTGCATTTCACCCCTGCATCCCAGTCGCCCTGCAGCCTCACACAGATCCTGCACACACCCAGACAGCTGGCGCTCAC
CCL2	ATGAGCCACCCATGCCTGGCTTTTTCTAGTTTCTTGACATAAAAGCTGAGGGCATTGATTTGAGACTTTTAAAATCTACGCATTTTAAAAGAAAAGCATTTTATTGTCCTGTATATTTCCATGTAAGTATTGCTTCAGCAGCATTACATGAATTTTGAAATGTTATTGTTTTCATATTCATGAAGTTCAAAATACTAATG
CCL20	AGCTGGAGAGCAGGTCAGGCTTCAACAAAAGTCCAGATCTGGGAAACCTAGCCTCTTACACAGATATTTTATATAAGGAAGATGAATTTCCTGTTTTTAGTACATCTTAGACTAGTTGAGCAATGGATTAGTAATAACAATTTGCATAATCTGGTTCTCGAACTTGCTGTAAGAAATGATCTAACAGAATCTACAAAGCA
CCL21	GGGGCTGGGTGCCAGCAAATCCAGCTTTCAGGAAGGAAAAGGAGTGGGGATAAGTTAAGGGAAGTGAAAGTGTCTAGCTACATAAATAGCAGGCCAATCCCAGCCCACGCACAGACCCCCAACTTGCAGCTGCCCACCTCACCCTCAGCTCTGGCCTCTTACTCACCCTCTACCACAGACATGGCTCAGTCACTGGCTCT
CCL22	GCCTACATCTTTCTCCCATGCTGGATGCTTCTTGCCCTCCAACATCGGACTCCAAGTTCTTCAGCTTTGGGACTCAGGCTGGCTTCCTTGCTCCTTGGCTTGCAGATGGCCTGTTGTGGAATGTCACCTTGTGATCATGTGAGTCAATACTCCTTAATAAATTTCCCTTTATATATACATCTATCTTTTTAGTTCTGTCC
CCL23	TAGGAATACATTGATTGAAATACTTACTTAGAAGTGGGATTTCTGGGTCATTGGGTAAACATATGTTTACTTTTATCACAAAGCACTAAACAGTTTTGCAAACTTTCCTCCAGCAACATATCAGATTTCCTTTTGCTCTATATTTCCATCAATACATGGTATTATCAATCTTCCCTATTGTAGCCATTTTAATGGGTTGT
CCL24	GGAAGTGGGGGGGAAAACTCAGCCGCCAGTGGCGTTTGTGAAAAGCACCTGGTAACAGGCTGTGCTGGAGGGGAGTTCAGCCCCTAGAAAAGATCACGGATTAGGAATTACATAAGCATAGGTCTCGGGTCCTTTTATTTTGGACGCGATCCTTTCACGGGATCGCCTCCGGATGGGAGCCGGATGGGATCCCGGACGGG
CCL25	GGCCATGGGGACACAGGCCATCACTCAGGGAGCACTCATCGATGTCTGTGGGGGAGTGCAGGTGAAAGACGGGCCTGTGCCCCATCTGCCGTCTGTGTGACCATGAGACACACTGGGGGCACACATGCATGCTAAGGAGCTCACACTGCCAGCATTGGCACAGCCCCGCATGTGCCTATCCGTACACTTGCATTCACTCA
CCL26	GGATGGCAGAGATCAGAGAGGAGCTGTCCGGGGTGGAAGTTTGCCTCCCATGGGAAGCCAGGTAAAAATGGATTCGTGGGCCTCGCTCTGAGACTCTGGGAGTTTGCATTTCAGGAGGCTCCTCCCGTACAGTGTTTCTGACGCAGCGGGGAAAGCCCTATTGAGGCACCCTGTGTTTTATTACTGGCCTGGCCTTCCAG
CCL3	CATTAAAATTTGTCCCATTAGCCAGGACACTCTTTCCACTGAAAGTGAGTGAAAAAAAAATTACCTCCAAAATTATATTGATTAAAAATGAAATGTATTGGTTCAATAACCTGAAAAGTCTCTAGCTTCAGGTGTAACTGGATCCATGTGCTTAAGTAATGTGATCAGGGCCTGGATTTATACTGCCTCTCAGCCTGGTT
CCL4	TGAATTTCTAAGGTTTAAACCACTCAGTCTTTGGCACTTAGTGACAACAGTCTGAGCAGTTTAAGACAAAGACACATGCAGCCCCACAGGGAATGTTACACCTAGGTGGCAGCATATCTGCCTACTTTCTAATGTTCCCAGGAGAGTCCAGAATTTGACCTGTCACTTTACAACTCCTCTTCCTTTGTGGTGGAAGGAGG
CCL5	AAATTATACATGCATGTTCATAGCATTTTTCATAATAGCCCAAGGTAGAAGGAATGCAAATATTCAATAACTGATGAATGGATAAATAAAATGTCATATATCTGTATAATAGAGTATTGTATAGCCATAAAAATGAGTAAAAGATTAAAGATACCACCACATGTATGAACCTTGAAAACACTATGCTAAGTCAAAGGTAT
CCL7	TTTTCTAAGCAGGAAAGCAAAATAATAATGAATTCAGAGAAAACTAGCTGCCACTTATTATTAAAATGAAAAAATTTTAGATCAGTAACACATATATTGGTCGCAGAAGGTTTAACCATGAAAAACAAATAAATCTCCCTTCTACCTCTTTCTCCCTGTACTGAGGTGTCTCAGTTCCCTCTCTAGAGACAAACACTGTT
CCL8	GGAGGAGAGGTGCTCTGATTTTTAGAATTTTCAGTTTTTCTGCTCTGTTTTTTCCCGATCTTTGTGGTTTTATCTACCTTTGGTCTTTGATGATGGTGACGTACAGATGGGGTTTTGGTGTGGAAGTCCTTTCTGTTTGTTAGTTTTCCTTCTAACAGTCAGGATCCCATGAATATATTAAAGGCTGTGAGAATTCTGCA
CD44	TGGGGCAGGTTCTCATATCTGCGTGCTGAAAGGCGTTTATTTGGTGTATTCTGAGAGCAGGATGCTGGTAACACTTTCTTTTGTGTTTTGCCAATTGTTTCTTTTTACTGGCTAGTCCACCCTGTCTGACGCATTCATTATACCATAACCACCTTGACACCAGAGTGAAATGCCATTTCTCTGCAGGTAGGAGAGAGTCA
CD58	ACTGAAAATGGAGCTGACTGTGTGACTCCTTTCAGTGTCCAGCAGGTTCAGCTACATGGAATAAATCAGTACCTACGTCTAGTACTTAGCATCTGCGGTGAAAAGCATGGTAGGAGGGCTGCATAGACCCTGTGATGCTTCCACTGCATCTGTGTCTGCCTCCTCTCAGCTGAGCAGGGTTCTTGTCCTCTAATCTGTTT
CIITA	TTTCTACATGCCCCATTGGGAATGAACCACTGACTTACGGTTCACATTGGCAACATTTTTTTTTTTTTTTTTGTCTTTTTCTGAAGTCTCTGATGGAATTCAGAGAGTTGGGGTGGGGCCAGGCCTGGCTTATGGGCTTATAATTTGTTTTCGTTATTTCTTTTGTTTTAGCACACCAATGACTTTGCCCTGTACACAGA
CX3CL1	TAGAGACAGAGTCTCACTATGTTGCCCAGGCTGGTCTCAGACTCCTGGGCTCAAGCGATCTTCCCACCTCAGCCTCCCAAAGTGCTGGGATTACAGTGGACCAGTTGCTTAAACTACTCTGGTCAGTTCCTAATTTTCTCATCTGTAGAAACTAATAGTTCTTACTCCCTGAAGCTGTTGTGAGGACAAAGTAAACTAAT
DAPK1	ATGCAAAATTTGTTCTAGGAATTCCGTATTTGTTTAGTTACAAAGAGAGACATTACTTTCAGGGTCTTCTCAGGTTTGGACTAATTTCCAAATGCAGAATGCAGAAGAGGTGGCTTTCCAGACACTATATTTCTCTATAAAGCTGAGGTAGAGCTTTGGCATGTGCTCAGTGTTTCTCCAATCATTGTAAAGTGTCCGGC
DAPK3	GGGAGGCTTGTGTTTGCTGGACAGGTCTGTCCATTAATCTAGGAGAAAAGGGTGGTGTCTCAGTTCCTCACTTCTGTCTTTCCCTGTCTTCTCCAGGGTTGCCATTAGGGGACTCCTGAGGTCCTATCTCCAGGCTGCGGTGACTGCACTTTCCCTGGAGTGGAAGCTGCTGGAAGGCGGACCGGCCGCCATGTCCACGT
EDN1	CCGCGTGCGCCTGCAGACGCTCCGCTCGCTGCCTTCTCTCCTGGCAGGCGCTGCCTTTTCTCCCCGTTAAAAGGGCACTTGGGCTGAAGGATCGCTTTGAGATCTGAGGAACCCGCAGCGCTTTGAGGGACCTGAAGCTGTTTTTCTTCGTTTTCCTTTGGGTTCAGTTTGAACGGGAGGTTTTTGATCCCTTTTTTTCA
EPRS	TTTTACATTTCAGGCGTGGCTTGGGAAATTACCTTGTCAAATGATATTATTTTTGGATCACTAGCTTCAAAGGGGCAGTGTTAGAGACTGTGGGCCCCATTATTGGGGAAGTTTTCCAAAACGCTAATTAGTAGGCAAATGCCCTTATGACACAAAACAAAATGATGAGCTTGCATCTTGTCAGCCACTGAATGTGTGCT
FCGR1A	CCTAATGCCTAAATAATTTCTTTTTAACTCCTATATCAATTTGTTTGAAGAACAGATGACACTTTGAATGGCCCAGCCCACAGCCCAGAATTTCAAGGGAAGACCTTGAATTCAAGGGAGACAATGTCTCCCGTAAAATCACCTAGGCACTTACATAGCATATTTTTCTGTCCACTGTCTTGCTAGTCTGTTGTAGTTCT
FCGR1B	TTAACATTGCATCTTAAGACAATGCAATAGCCATGAAGTCTTTATGAGAGCAAGGTAAGAAGGAAGTTAATCTATAATGAAAGTCAGCAGTGCAGAGGGAAGCAATCTTCCCTGGCACCCTTCAATAATTTGTATAACATGTTAGAAAACAATGCGTGTGGCTGGGTGCAGTGGCTCATGCCTGTAATCCCAGCACTTTG
GAPDH	GGATCTCCTCCTCCATGTACTTCCAGGCCTTGGCTGTGGGGGTTATGATGCAGGTATTCTCCACGATCGAATAGCACAGCACCAGCAAGGCCTCTGTGTGGGGCAGCTGCAGGAGGCTGCAAGAAGACAGCACTGAGGGTGGGGCTGGGCCAGGTGGCCCGGGCAGGAAACTACATCCAGTCTCTTCCCCTTCCCTTAGT
GBP1	CTCAGTTTTGTTAAAAGAAATGAACTTAAAATCTTTAGATGAACAGAATTTATCTTAAATTTGTCCACTCAGAGCAAGAAACATTCTTCAGTGCAATGGCTGATGGCTCAACCCCCAAGGCTCAGTCATGCCATACCACAATACATGGAAAATACCACAATACGTGGAAGATGCATGGAAGTAGAGTGCTCCCTGCCATC
GBP2	GCTCCCTACCCCCCATAATACTCTACATATTGGCTGGGGACAGGGGCCACCTACAAAAACTATGAAATAATGTAGGTTCCTTGGTTCCAAAACTGGCTTTGTTAGAAACAGGGATAAAAAGGGCACTCAGGGACTTGGCCTATATCCTCTGACGGGCTAATGCAGACCGGCTGGGAGACAAGTTTCTAGGGCCATCCAGA
GBP5	TTGTGGGCCTCTAAAAGCCCTCTGTGCCTATTGCTCCTAATGGACGAATTGGTCCTGAGGTCACTGGGACAGTCAGGGCTCTTCTGGCCTTCAGAAAGAAATCTGGGGCTGGAGGCAGAGCAGAGAGGGCCCCACCCACTCCCTAACTTCACTTTACCTGTCTGAGACACTCTGCCAGGGAACTGGCTAAGAGAACTGCG
GBP6	AACAATTCTGAGTGAAAGATAGACTTATTCCCACTCTACGGATGAGGTCATAAGGCTGGAAAGGTTATGTCATTTGCAACAACGTCACATAGAAGTGGCGGAGGTGGAATTTGAAACCAGACTCATTTTATACCAGACTTTTTTATTTTAAACCAGACTTTTTAATATTTTATAATATATACCTATTCTCTTATCTACTG
HCK	ACCCCCATTCTCTACTATGATTAAATCACCTTCTACCAAGCCCCACATTTAACATTCCCAATTATAATTCCACATGAGTTTTGGTAGGGACACAGAGCCAAATCATATTATTCTCCCTTTGGACCCCCAATCTCACAACCTTCTCATACTGCAAAATACAATGATGCATTCTCTACAGTCCCCCAGTGTCTGAACTCATT
HLA-A	TTCCCTCTTGTCTCTTAGTGCTACGGTTATGCATGACTCATACTTGAATTGCAATGTGTACACAGCTTAAGGACTTAACTATTAGAATACAAGAGGCCCAAACTACTGTTGTTATAGATATGTAAAACTATATGGTATAAGGTTAAACAACCCACAACTAATTAACAGTGAAGATAAATTAACTACATTGCAAATTTAAA
HLA-B	GGTATCTCTGCCACATTTTGGTATCAGGATGTTGCTGGCCTAATAGAATGAGTTAGGGAGAAGTCTCTCCTCCTCATTTTTTTTTTTTTTTGGAATAGTTTCAGTAGCAATGGTACCAGCTCTTCTTTGTACATCTAATAGAATTTGCCTGTCAATCATCTGGTTCTGGGTTTTTTTTGGTTGGTAGGCTGTTTATTACT
HLA-C	CGTTGAGTGGTGGAGCAGTGACAAGCACCTGGCACCCTTGGTCTAGTCCAGTATTCTGGGTGCCACAAGAATTGCAGAATTGCAACCTTGATTTTTATACATTTGGTTATTTTCTCTTTTTTTATTTCCTTTTTGTTGTTGTTGTTGTTGTTGTTGTTGTTGTTGTCGAGACAGGGTCTCACTCTATCACAGGCTGGAGT
HLA-DPB1	GATGGTTTGACTTTCTCTTTACCTATTTGTATGTCCTTTATTTCTTTCTCTTGTCTGATTATTCTGGCTAGGACTTCCAATCCTATGTTTTGTCTTTTTTTTTTTTAATTTGTAACTTCCCTTTTCTTTTTCTTTTTTTATTTTTATTATTATTATACTTTAAGTTTTAGGGTACATGTGCACAATGTGCAGGTTAGTTA
HLA-DQA1	TTGTTTATTTTACACCAGGCACTGAATTTTCTACCTTCACTTTGTTTCATTTAATTCTCATCATAACCCTGCAGTGGATGTATGTATCAAACTGTGTTTTCAGTTAACTGCTACATTCCCAACACATTCAATAATGTCCATCACTTATAGTATTTAATAAATATTGATTATGACTGGGTGCAGTGGCTCACACCTGTAAC
HLA-DQA2	CCCCACCACAGTCCCCAGAGTGTGATATTCCCCTTCCTGTGTCCATGTGATCTCATTGTTCAATTCCCACCTATGAGTGAGAATACGCGGTGTTTGGTTTTTTGTTCTTGCGATAGTTTACTGAGAATGATGGTTTCCAATTTCATCCATGTCCCTACAAAGGATATGAACTCATCACTTTTTATGGCTGCATAACACTG
HLA-DQB1	ACCCTTCTGGCTGTGTAGCAAATAACATGTTTTTATCTTTTTTCCTGTATCCAGACTTACCTGCTTTGTATCTCATGGAAATTCCTTAGGACTTTGGCAAATGAGCAAAATGTTTTGGGATGGTAGTCCAGAATTTCACCTATTAAAATTACAGTTTAAATAACTCAACTCCAGTTAAGAAGTTAGGGTGTTAAATGTAG
HLA-DQB2	GTAGAATGACGTAAGGAGCACTTTATTTATATCATAGATTCAATGGAAAAAAGGAAGGGTGGCGGGGGGTCTGGGTCTTGTCGGGGTGAGATCACTACTAACCTCTGCTTGTTATACATTTTCATATCTTCTCTCCTACACAACAGTATCCCCATATAATTTCTGGACTAGTAGTCATGGAAGACTGAGATCCCATTGTC
HLA-DRA	CCTTTTCCTACACATAAGATAACGTCTGATTGAAGGATACCTCTGTAACCTATAACCAGATCTGCTCATACACCCAAACGTTGATGTAGTTCGGCTTCAATGTAGCTTCTGAGCTAATTTGATGTAGTGGTTAATATGTAACCTCCTGACATCGAAAAGGATATGGATTTGTTTCTGAATCATAAAGTTTTACTGATTGT
HLA-DRB1	GAGGCAGGAGGGGGCTTCTTCTTATCCTTGGAGGCCTCTGTGGGGAGGTGACATGGGAGGTGGGTGCAGGGGGCTGGAGAGAGAGGAGACCTTGGTTGTCTCGTGTCCTTAGAGATGCAGCGAAGGGAAATGTAAGGTGTGTGTGGTTGGGGTGAAGGTTTAACGGAGGAGAGCTGAGGGGCATGGAAGGTTTGGGATGA
HLA-DRB5	GGTGGCTTGTTTCTCATTAGACAATCTTTTTTAAAGTGTCCTTGTAAACCACACTGATAACAAGCCTTACTGGGTGATTGGCCTGCTCCATTTTCTGTCCTCTCTGAACCACCAAGGTTTGTTTGTCTGAGGGCCATGACTAAGGCTGCGGCCTTTCTCTGATCTCACTTTTCCTTTTCTGCCTTTTCCTCTTGGTCCCT
HLA-E	AGTAGCTGGGATTACAGGTGCCCACCACCATGCCCAGCTAATTTTTTGTATTTTTAGTAGAGACGAGGTTTCACCATGTTGGCCAGGCTGGTCTTGAATTCCTGACCTCAGGAATCCCTGACTCTCCAAATGTCCCCACTTGTTATGTCATTCCCACTGACAAAACAAAAATAATGCTATCTTGTGTTAGGCTGTTCTTG
HLA-F	ATTTTCTCATGTGAACTTTATAATCTACTTGTCTAGCTTGAGAAAAAAAGTAGTTGTTGGCATTTTGATTAGGAGGTATTACATTTGAAAATTTACTCTGCAAATGTGCTGTATAGTCTTCCTATTTGAGAATGTTCTTCTGTACTACACAGCCATAAAAAGGAATGAATTAACAGCATTTTCAGTGACCTGGATGAGAT
HLA-G	GAACATTTTAAATTTTGTCTTTCTCTGTCCTTCCTTCCTTCTTTCCTCCTTTCCTCCCTCAGAGCTTTCTCCCTCCCTCCATTTTTTTCATAAACTCCAAGTGTTTAGGCCAAAAGGAAGCATTATTTGAACTTTATGCTAAAAGTATAATGCCGTAATTTATAATATAAAAGTAAAGAAAAGGAAGTTGTTAATGGAAT
HLA-H	CTATTTTTTCTTCTAGCTAGAACTACCTTATAATAAAATTTGTGAAGTGAATCCACAGAAATTGAGCAAAATAAAAAGGAGTCGTTGAGTGTGAGGAAAGCTACAGAGAAGTAAAGACAGGTGGAGACATGACAATACTGAGCATGTTAGTGACCTTCACAGTAACTGACTTCCTGGAGGAGTGTGAGCTTAAGCCAGAA
ICAM1	TTTCACCTGCCCAGCCAAGTCTTAGCAAAGAAGCCTATTAAGTCATCCGCTCATCCTTGATGTCTGATCAACTTCCTCATCTTCCACTTTTTTTTTTTTTTTTTTTTAAGATGGAGTTTCGCTCTTGTCGCCCAGGCTGGAGTGCAATGCTGCGATCTCGGCTCACTGCAACCTCAGACTCCCGGATTCAAGCGATTCTC
IFI30	ACTACACTCCAGCCTGGGCAACAGGGCAAGACTCCATCTTAAAAATAATAATAATAATAATAATAATAATAATAATAATAATAATAAAGACCTGGCCTGGCAGGCCTGGGATTCAAATTGCCAGGGCAGGGAACTGGAGGTGTGGGTTTGTTTTGTCTCTAGATTGGTTAGGAAGGTGTCTGTCTGCCTATTGGAGTGTG
IFNG	TGAAGTTTGCTGCTGCCACTGGAGCCACTCCAATTGCTGGGCGCTTCACTCCTGGAACCTTCACTAACCAGATCCAGGCAGCCTTCCGGGAGCCACGGCTTCTTGTGGTTACTGACCCCAGGGCTGACCACCAGCCTCTCACGGAGGCATCTTATGTTAACCTACCTACCATTGCGCTGTGTAACACAGATTCTCCTCTG
IFNGR1	TCCGAACCTTTCCATTCTTTTTCCTCATCAAACTTTGTATAGTGTCTCACTCTTAGTATCTTACTCTGTGCTAGAATATTCTAGCTTACATACACTTTTGTGTTAAGGGAATGATAATGGCTTGGTGACTAATCCTCAGATTAGATATTTAGTGTTTAATAGAAGTTTCTAGATACACAGAAGCTTAGCCCAAAGAAGTG
IFNGR2	ATCTTTAGAATGACATGTATGGTGGCTCAGAACTGTACCCTTTAAAACTCAGCTCCAGTAAAGGGAGATTCTGAGCATTTTAAGATGTTGGAAATTGAGTTGCATCCTGCATTAAAGGCATTTCTTCTTTATATAAACTGTAGGATTCTGTTAAGACAGAAATGGGGAGAGCTAATGGGCTATTCTGAAAGAACTACCCA
IL12B	GCACAAAGGTAATGGAAATGTTGCACTGTGCCCCATTTATTCATTCAACAAATATTTATTAATCATCCTCAGTATGTTAGTTACCGGAGATACCACGTACATAATGTGCAAAGATGTGCATAATCCCTGCCCTCATAGAAATTATAGTCTAACAAGTCTGATTTCCTCAAGTTTCAGTTTGTTCCATACTTTCCTCAGTG
IL12RB1	TGTGGGATTTGTCAGTACCTTCAATAAGTTGCTTGGCACTGGGAATCTCCAGGTGTTCCCTTTCCTCAGAGAAGCATCTCTGGGAGTTGGCATAGGGCGTGGCCAGGGTCCTCATCCCTGCCTTCTCTGACCACAGGGTTCGAGTTCTTTGAGGCAAGCGCCAAGGACAACATTAACGTCAAGCAGACCTTTGAGCGCCT
IRF1	CCAAACTCTATCAATCATGGCTACTCTTGAAATTTTACGAGGTATATTTAAGTTAGTAATGTCTAAAAATGAACAATAACTCAACTTTGTTGGCAAAAAATATAAGGACCTTACAGTACTTTTAAGTTCAATCGTCCACTCCCAACTTACATATTTTTGTTTTACAGTATTTTGGTTCTGTCTTTTCTTTCACCCCAAAT
IRF2	GATGCCTTTGAAAGCTCGGAGAAATAAATACGTTTATTGTTATGCTGTTAGAAAACAAGTTCATGCTTGTCCTCTAAAGATAAGTGGTCTTTTCATTCTACTTTTTGTTTTGTAGTAAGAGCCATAAAATTTGCAATCGCAAGTTTATGTTGTTATACTTAGTTACCCAAGGGGTAGTTTTAAGCATTTTTATTCATATG
IRF3	GTGTACAGAGAACCCCTGGGCCTCGGGAGGGTGTGGGGACTCTGGCCTGAGGGGCAGCCTCCAGGCCCAGTGTGTGAGCAGAGCCCATGTCACCCCTCAGTGCTGGTGATGGAATGAGAGGAACTGTGGGTGTGACCGTGCCCCACCCGTGGGTGTGAGAGTCACTGAACTAGGTGAGAAGTGCCCCACGGGGCAGGTCA
IRF4	AAAGTCCCTCTCCCCAGTCCAACCCCCGGCCCCCACAGGCCTCGGCGCCCCGCCCCGCCCCAGGCCCCGCCCCAGAGAGTTCTATAAAGTTCCTCTTTCCCACCTCGCACTCTCAGTTTCACCGCTCGATCTTGGGACCCACCGCTGCCCTCAGCTCCGAGTCCAGGGCGAGGTAAGGGCTGGAGTCGGGCAGGAGGAGG
IRF6	TGGAGAGTAGGGGGCAGCAGGAGGGAAAGCACCAAGACGAATAGCTAATGGATGCTGGGCTTAATACCTAGTTGATGGGATGATCTGTGCAGCAAGCCACCATGGCACACATTTACCTCTGCAACAAACCTTCGCATCCTGCAAATGTACCCCTAAACTTAAAAGTTGGGAAAAAAAAAAGACCCATTTGTCTGCTGTCC
IRF8	CATCCTCTTCCAGATACTCTTAGAGAGTTTAAGGAAACAACCTGTGACTAAGTGACCTTTCATGGCACGAAGGACATTACAGATGTGATCCTGAGTTGGGGAGAGCAGCCTGGATTATCCGGGTTGGCCCTGTCAATCGAGAGGGCCGGTCTCCCACGGGTCGCCCTAGTGCACACGGTAATGGGCAGCACGAGGGTTTC
IRF9	TTGCCACACAGGCCTGGTTTTTCTGAGGCCCCTCTCTGCCAGGGCATGAGATGGGCTGGCGTCTCAGTGGCAAGGCCCTTATGGAACCACATGGGTCTCTGGGTATCTTAGGTGGGTAGATATGAGGGAGGGGCCAGATCAGATCAGTGTGGTCTGGAGAGGACAAGAGTTGGTGGATTCTGAGAACACTCAGCAGGGAT
JAK1	GTCATGAGAGGCCTGCTTCAGCGTTATCTGCCTCTCCAAGCACATCCCCAAGCAAAAGGTTTCGATGCACTGCATAAGGTGGCAGCTGCCTACAAGACTGCGTTAATATATTTTCTGAGAGCACCGTGACTACATGAACAGCCAAACAAGTAACATAATTTGAGTAACATAATCTAAATTTGACAGGTCTATTTGCTGAG
JAK2	GCCAGTGTCGCCCGCGGCGTTGAGAAGACGGTGTGGCCCCGGAGAGGGTGGAGACAACTGTGACGGGCTTCCCGGCTGCCCGAAGTGGGAGTGGTGTGGGGCTGCAGGAAGGAGAGAGGAAGAGGAGCAGAAGGGGGCAGCAGCGGACGCCGCTAACGGCCTCCCTCGGCGCTGACAGGCTGGGCCGGCGCCCGGCTCGC
LGALS9	GATGTTTGTATTCAACTCCCAGAGTTGAACTTTCCTTTGGAAAGAGCAGCTATGAAACACTGTTTTTCTAGAATCTGCAAGTGGAAGTTTGGAGGGCTTTGTGGTTTGTGGTGGAAAAGGAAATATCTTCACCTAAATACTAGATAGAAGCATTCTCAGAAGCTTCTCTGTGATGACTGCATTCAACTCACGGAGTTGAA
MT2A	GTGGTCCGCTATCAGTCTGACTGATTGCAGAAAGCAACCAATTAGAAGCTGAAGTGAAGTTACAAAGTTACTCCTGTGCAAATGAAGATGTAGCCCAAGACCAGCCCAACTGGTTGCCATAAGGGGCAAATCAGAGGTACTTTCAATTTCTCATCTCCCATGCAGACAAAGTGGGGAGGGGTTGCAAACGAAGTAGCCTC
NCAM1	TGACCACCCACTCATCACATTCATAGACACACACATACCATAGCCTGTTGTCAGCTTCTGTTCTCCAGAGCACCACTGAAGACTGTGTAGGTGGAGTTGTCCAACAAGGCTCCATGAATGGGCTCCTTGCTGGCCATTCTCTTTGAGATGAAAGGACTGCAGATCAAGCTGTATGGTCAGAGAAGGACTCAGTTTCAGTC
NOS2	GTGTTTCTAAACTGCTACATCGCAAGGAATGTTCAGCTCTGTGAGTTCCACTCAATCATCCCAAAGAATTTTCTGAGAAAGCTTCTGTCTAGATGTCGTGTGAAGTTATACCCGTTTCGAACGAAGGACACAGAGTGGTCCAAATATCCACTTGTAGATCCTGCAAAAAGAGTGTTTCAAACGTGAACTTTGAAAGGAAA
OAS1	GAAAGAAATTTTTGTTGTTTCTTTTTTTTTTTTTTTTGAGATGGAGTTTAGCTCTTATTGCCCAGGCTGGAGTGCAATGGCACAATCTTGGCTCACCACAACCTCCGCCTCCTGGGTTCAAGTGATTCTCCTGCCTCAGCCTCCCGACTAGCTAGGATTACAAGCATGTGCCACCACGCCCGGCTAATTTTGTATTTTTA
OAS2	GGCTGCTATGCACAGGACTGGAAGATGTAACGTGATCTCCTGCAGTGCACATGACTGCCGCTCACACCAAAGAATGATCTGGCCCCAAATGTCAGTAGTGCTGAGGTTGGGGAATATGGGGTGAGTCCACCTCCAGGTGGGGCACTTGTCATCAGATACCGGTTGAGTCATGAGTCCTGGGTCTGGGGGGCTGGGAGGTC
OAS3	CTGGCTTGACACAGCATTTTTTTTTTTTTTTTTTGAGACAGAGTCTTGTTCTGTTGCCTAAGCTGGAGTGCAGTGGCACAATCTCAGCTCACTGTGACCTCTGCCTCCTGGGTTCAAGTGATTCTCCTGCCTCAGCCTCCCAAGTAGCTGGGATTATAGGCGCGCACCACTGTGTCTGGCTAATTTTTGTATTTTTAGTA
OASL	TGGCTATTTCAAATGGTGACAATAGATTTTGTCAGGCTTTTTCTATTTTGAGTGTCTTGATGGATCTATGAAAATCCATGAAATGAAGAACAAGAATGGTAACTGAAGAGAGAGGCCCATGGCAGCAGCCAGGGAAAGGGAGGAGGGAGGGAAGGAAGGAGGGAGAGAAAAGCCATATGTATTGGAATTAAAGTGTCATC
PML	CCTCATAGGGAGAGAGGGGGGCAAGTCTTTGATGCTACTCTGGTGGCTTCTTTTCAGACTAGTTACAAAGATCTCTCTGGAGACCAGCCCAGAGTGAGGACAAGTGGCCACTTAGCAAATATAGAGGAAAGGGCAGGGGACAGGCAGCATCATGCTGGCTTTTGAAGAATTTTTATGGATTTTTTGTAAGCCACACCTGA
PRKCD	GGGCATGAGCTCAGCGTGCACTAGGTGCATAGGAAACAGCAGCCACTATGACCCCGTGCCCGGGTGGGATGAAACATGCTCAGGAGAGCAGGCCTGTCCACTGCACACTGCACTTCGAGTGCAAGTCCTCTAACTGGACCGCAGGTGGGCGGTTAAATGCACCCGCCTCATGACCCAGTGGTGCCTTTCAGGCAGAGCTA
RPL13A	GGTGTTCATTAAAAAAATAATTTTTTTTTTTTAAGTTTTGAGACAGGGTCTCACTGGGTCACGCAGGTTGGAGTGCAGTGGTATGATCATGGCTCACTGCAGTCTCCATCTCCTGGGCTCAGGTGATCCTTCTACCTCAGCCTCCTGAGTAGCTGGAACCACATGTGTATGCCACTACACCTGGATAGGTTATTATTTTT
STAR	TCCTGACTTCAGGTGATCCACCCGCCTTGGCCTCCCAAAGTGCTGGGATTACAGGGGTGAGCCACCGCACCTGGCCTTTAATATTCTTTGAATCATCTCCTTCCCATTGCAATAGGTTGGACGACTACCAACTACTCTAGGAATTTTTTCATCTCCTCTAATAGAAGACCCATTCCATATGAGCAGGGACTTTGTCTTCT
STAT1	TCTGGGGTGTGGCCTAAAATTCTGCATTTTTAATAAACTCGTGGGTAAAAGTCAATGTTGTCAGTCTGCCAATCACATTTTGTGTAGCAAGACTAACCATTACCTTCAGCATTATATTTTTGATTACTCTGGATTTTGTTTTGCTTCCTAGAATATGCTAGTTTTCTACTGGATTTGACTTTTGATCAGGACCATTGGTC
TLR3	TTTCTCTTATAGATGAACCTGAGAATAATCTGTCAAGCTGCTGATAAAAATTCTTTATGAAGTTAAAGATTGCACAGAACTTACAAATTAAATTGGGAGAATTGAATTTCCTGTAATATTGAAGTTTCTCAACCAAAATATTGTTACCCATTTCTATTTTTCACTTTTTAAAAAATGTATGAAACAACATTTATAGCCTT
TRIM21	ACCTGTCCTTCAGACATGTCTTCTGAGTAAACTGTGGGGATACAACTGGCTAAGGAAGTGTTCCTAGAGGGAGTCATTTACCTGTCGGCATCCTCCAGTGTCCCCAAGCTGGGTTCAGTGCATGTCTCCATCAAACACAAGTCACACCACAGTCTAATTATTATACATTGGAGCAATTATCAAGGTCAGGGCATTGTGTA
TRIM22	AAGGCACTTTTCTATGAATTTTAAATATAAAAATAAATATTGTTCTGATTATTACTGAAAAGATGTCAGCCATTTCAATGTCTTGGGAAACAATTTTTTGTTTTTGTTCTGTTTTCTTTTTGCTTCAATAAAACAATAGCTGGCTCTACTGAAGTCTCATTCTTCAGTTTCCAAAATCTTGCTGCAGATAATATGAGTTT
TRIM25	GTGAAAGGGAGCTCATTATATATTTCTTACACTGAAGAGGAGAGTAAGACTTTCTAATTCCTAAAAAAAGACATTTTCTGGTTTTAATGAGTGATAAAACTCATTAGCTCAAGCTACAAGAACTGCGAATTCAGAAATTAGATTTTGTTTGCTGTTTCTGTTTTGTTTTGCATTTAGTAGAGGCTAAATGAATGTAATTA
TRIM26	AAGACCCACTAACGCTGTTGTCAGTTTAAGCCACTCTGTGGGCCCTAGCACAGGCTCATTCAACCCACCGCTGCCATCACTAGGGCCTGAAGACTGGCCCACCTAGCATCTTAGTTCCCAGCCAAACTTCACCACAGCCTTCACTAATAAGTGCACCTTAAGTCAATGAGGAAGTCACAGATACCACTGATGTTGTATAC
TRIM31	ACACCATGGAATACTATGCAGTCATAAAAAATGATGAGTTCATGTCCTTTGTAGGGACATGAATGAAATTGGAAATCATCATTCTCAGTAAACTATCGCAAGAACAAAAAACCAAACACCGCATATTCTCACTCATAGGTGGGAATTGAACAATGAGAACACGTGGACACAGGAAGGGGAACATCACACTCTGGGGACTG
TRIM38	GGCCCCTCCAACTCTGAAAATGGTCAGGACTTTCTTTGTTTTACAGCTCTCACCTCTTTCCTGCTCTTTCTTTCACCAGACTTTACACCAAATCTCAGAAGATTCAGAACTTAGATGAGTGGGGCCCAGGACAGGAACCCTGGAGCCTTGGAAGGAGGGGAGCCCCATCTCCCCAGAAGAGCAGTGACCCCAGCAGAGAG
TRIM5	ATTTCTTTTATCTGAAATTAAACTTTAACTGAGCATCCTGTATTTTGTCTAGCAATGCTCAAAAAAGTAATAGGCCCTCCTATCTTACAAAGTTTTATCCACCTTCCTCCCCACACTCTTACTATCCCTGGATATGGTGGGAATAAATAGATGGTCACAGACTGGGGACAAAGTGTGGAGATAAGATTCAGACTGACCAC
TRIM62	CCCCATAAACTTTTTGTAAAGCATCAGTGATGTCACCATTCTTCTACCCAAGCTTCACCATAAATTTAATGTTTTTCCTTGCTTCAATTTTAGCAGAATTCATGTTGCTCTGATAGAGGCTTTTTTCAAGCTGATATCTTGTCCTTCTTAATGCCTCACATTAGATCCTGTGCAGACATGTTATAACAAGTTAGTGTGAG
TRIM68	GACTTAAATGTGAAACCCAAAACTATAAAAACCCCAGAAGAAAACCAAGGTAATACCATTCGTGACATAGGAACAGGCAACTATTTCATACAAATACCAAAAGCAATTGCAACAAAAGCAAAAATTAACAAATGGGATCTAATTAAACTAAAGAGCTTCTGCACAGCAAAACAAATAATCGACAGAGTAAACAAACAACT
TRIM8	GGCTGCCTGTTAGTCTTGGATGTTCGTGGCCTTTAATGATATTGGTCACCAGCATCTCCACCATCTTTCAATTGATCTTTGCATCCTTTTATTACTTACAGAAAATACGGTTTTGTGAACTGCCCTCTTTTTGAAAGCATTGCGTTAGCCAAGCCCTTTCTCTTAGAATCTGGGGACACAGCTAAAGTCCCATTGGTAGG
VCAM1	GATATATACATAAGATATATACAGAAGAGGCACTCAGTGTATATTTGTCAAATGAATGAAACAAAACTTTCTGCTCTTTGACTGCTTTTTCTCTGATACCATGTCTCCTTACTTTGGTATACCTGAGAAGCCAATGTTAAAACTTCCTTCAAGAGAGCGTGTTCTTTATCTGATTGAAATTTTTGTAAAGTTCATTAATA
WNT5A	AGGCAAGCCTTCAGCCCTGCCTGAGAAACAAGGTCAAATGCCTCCATTTTTGCACAGCTGAATCAAGCACTGGGTTGTAGGATCTTGGCGGTGAAGAGGTTAAATTGCTCAAAAGGCTGGATCTGTGGTTTCCTGCCCACACTTGCTCTGGCCTAAGGCAGTGCTTGCTGTGTGGGGAGAGGGAAAGGGAGGTCTCGCCT
XCL1	TACAGTGGACTAACTGGTTACCCAGACCAGGGCCTCCTCTCAGTCTGTTCTCTGCAGCTTTGCCAGGGTAATCACTGTAAAGCCTCAATCTAATCATGCCATTTCCCTACTGAGAACCTCTTTGCTAACTTCCAATGCCTACAGGATGTATTTCAAATCTTTCATTGTGATATATAAGAATGCTCAAGATCTAGTACTGC
XCL2	AGCCAGTACTCCACCTCAGGCTCAGTGGACACTGCTGGCATGCAAAACGTCATGGACTTTCTATGACACCTCAAAGCCCGAGGCAGCACAAGAACCTTGGAGGGTGCTGGGAGCCCTTATCCGATGCCTTAACTCCCGTGTCAGTGATCTTTAGTTTCCTCCTTGACATTTAACCTTTCTTGACACTTGCCCTCCCCCAA
